~~~~~~~~~~............~~~~~~~~~~
~~~~~~~~~...*....**....~~~~~~~~~
~~~~~~~~.....*....**....~~~~~~~~
~~~~~~~..................~~~~~~~
~~~~~~.....***............~~~~~~
~~~~~....***.....%%%%%.....~~~~~
~~~~......**.....%%%%%......~~~~
~~~....**.....%....%.....**..~~~
~~....*.*.....%....%.....**...~~
~...*.........%%%%%%...........~
.*.*....%.............%%.%%%%%..
...*....%.............%%.....%..
........%...x.x..x.x..%%.....%..
.%%%%%%%%.............###%%%##..
................................
##%%%xx%%%##%%%xx%%%##%%%xx%%%##
##%%%xx%%%##%%%xx%%%##%%%xx%%%##
................................
.##%%%###..............%%%%%%%%.
.%.....%%...+.+..+.+...%........
.%.....%%..............%........
.%%.%%%%%..............%........
~..........%%%%%%..............~
~~.........%....%.....*.*.....~~
~~~........%....%............~~~
~~~~.....%%%%%.......*......~~~~
~~~~~....%%%%%......***....~~~~~
~~~~~~...............**...~~~~~~
~~~~~~~..........*.......~~~~~~~
~~~~~~~~......*.**......~~~~~~~~
~~~~~~~~~........**....~~~~~~~~~
~~~~~~~~~~............~~~~~~~~~~